Day #1
powerful - сильный, крепкий
prepare - готовить, подготавливать
lean - наклонять (ся), опирать (ся)
life - жизнь
take back - отдавать, возвращать
yourself - себя, себе, сам
bother - беспокоить(ся), надоедать
future - будущий
tear - рвать (ся), отрывать (ся)
question - вопрос

Day #2
strict - строгий
hard - активно, упорно
tap - кран
address - адрес, обращение, речь
back - назад, обратно, сзади, позади
load - грузить, загружаться
enemy - враг
repair - ремонтировать, чинить
anywhere - где-нибудь, куда-нибудь, никуда, везде
crash - рушиться, грохотать

Day #3
cook - готовить
hope - надежда
mean - неприятный, противный
announce - объявлять, извещать
fall - падать
admire - любоваться, восхищаться
little - маленький
care - заботиться (for, of, about)
young - молодой, юный
film - фильм

Day #4
male - самец
meaning - значение, смысл
I - я
fault - недостаток, неисправность
experiment - опыт, эксперимент
after - за, позади
common - общий, всеобщий
throw - бросать, кидать
if - если
reach - добираться до, протягивать

Day #5
breath - дыхание, вздох
sweet - сладкий
follow - следовать, следить
second - секнда
neat - аккуратный
meanwhile - тем временем, между тем
throughout - по всему,  повсюду; все время
art - искусство
used - подержанный, использованный
strike - забастовка

Day #6
pinch - щипать, красть
level - плоский, ровный
break - перерыв, разрыв
wealth - богатство
complicated - запутанный, трудный для понимания
give away - отдавать, дарить
offer - предложение
opposite - противоположный
danger - опасность
real - реальный

Day #7
knock - ударять, стучать
impressive - впечатляющий, выразительный
pull - тянуть, дергать
frighten - пугать
rain - идти, литься (о дожде)
indeed - в самом деле, действительно
crime - преступление, нарушение
steep - крутой
strange - странный, незнакомый
by - у, при, около, возле, рядом с

Day #8
call at - останавливаться (где -л.), заходить
suggestion - предложение, совет
arrangement - размещение, расположение
mainly - главным образом, преимущественно
pair - пара
hour - час
confused - смущенный; озадаченный
open - открывать (ся), раскрывать (ся)
criticize - критиковать
pencil - карандаш

Day #9
shout - крик
turn off - сворачивать, выключать
backwards - назад, обратно
gather - собирать (ся)
half - половина
condition - условие
call off - отменять, откладывать, переносить
hole - дыра
few - мало, немного, несколько
hear - слышать, услышать

Day #10
bet - пари
influence - влияние, действие
nurse - медицинская сестра
confidence - вера, уверенность
sensitive - чувствительный, впечатлительный
alive - живой
job - работа
problem - проблема
in - в, во
characteristic - характерная черта, особенность

Day #11
draw - рисовать
better - лучше
hold on - подождать
exit - выход
behave - вести себя, поступать
wise - мудрый, благоразумный
example - пример
turn into - превращать во (что-л.)
clean - чистый
pin - кнопка, гвоздь

Day #12
land - земля, суша, почва
brave - смелый, храбрый
heat - жара, тепло
compare - сравнивать, сверять
evening - вечер
black - черный
bend - сгибать (ся), гнуть (ся)
small - маленький
weekend - выходные дни, уикэнд
remark - замечание, высказывание

Day #13
beat - бить, колотить
try - пытаться, стараться
chat - непринужденно болтать, беседовать
force - заставлять, принуждать
trousers - брюки, штаны
themselves - себя, себе, сами
hand - рука (кисть), стрелка (часов)
shall - следует
language - язык
no - никакой, нет

Day #14
bring forward - выдвигать (предложение)
suffer - страдать
shock - потрясать, шокировать
port - порт
excuse - извиняться, просить прощения
shop - магазин
vote - голосование
last - последний, прошлый
between - между
protest - протестовать, возражать

Day #15
lonely - одинокий
care - забота, уход
next - следующий, потом, рядом
shame - стыд
there - есть, имеются
turn away - прогонять, не пускать
come back - возвращаться
slice - нарезать ломтиками
speech - речь
clearly - ясно, очевидно

Day #16
low - низкий
transport - перевозка, транспорт
bury - хоронить, закапывать
miss - скучать, пропустить, не попасть
marry - жениться  или выходить замуж
line - линия, очередь, веревка
tidy - аккуратный, опрятный
aim - домогаться, стремиться
light - светлый, легкий
car - автомобиль, машина

Day #17
regional - бластной, районный, региональный
no one - никто
figure - цифра, фигура
precise - точный, определенный
crash - грохот, авария, крушение
interesting - интересный
opportunity - благоприятная возможность
on - на, в, по
you - ты, вы
post - посылать по почте

Day #18
centimetre - сантиметр
unpleasant - неприятный, противный
disgusting - противный
charge - плата, цена
delight - удовлетворение, удовольствие
song - песня
equipment - оборудование, оснащение
pay - плата, заработная плата
visit - посещение, визит
whichever - какой угодно, какой бы ни

Day #19
turn on - включать
stage - ступень, сцена
ticket - билет
pump - качать, выкачивать
priority - преимущество, приоритет
moon - луна
steer - направлять, управлять
exciting - возбуждающий, волнующий
pleased - довольный
free - бесплатно

Day #20
illness - болезнь
trial - судебный процесс, суд
comment - комментировать
loud - громкий, шумный
string - веревка, шнурок
imagine - воображать, представлять себе
scale - вес, шкала, масштаб
drink - напиток, глоток
shout - кричать
healthy - здоровый

Day #21
cross - крест
central - центральный
unfortunate - неудачливый, несчастливый
bring - приносить, привозить
sport - спорт
patient - терпеливый
boil - варить (ся), кипятить (ся)
display - показ, выставка
except - исключая, кроме
estimate - оценка

Day #22
introduction - введение, представление
either - один из двух, такой или другой
active - активный, деятельный
model - модель, макет
come over - приезжать, приходить
entertainment - развлечение
beyond - за, по ту сторону, за пределами
dig - копать, рыть
relative - родственник; родственница
true - верный, правильный

Day #23
description - описание
beneath - под, ниже, внизу
wind - ветер
pour - лить, наливать
funny - забавный, смешной
murder - убивать
form - форма, вид, класс (в школе)
mean - иметь в виду, значить, думать
minor - незначительный, несущественный
edge - кромка, край

Day #24
return - возвращаться
always - всегда, неизменно
demand - требовать
plan - план
turn out - оказаться, выключать
hurt - ранить, обижать
chase - гнаться, преследовать
heavy - тяжелый
single - единственный, отдельный
concern - отношение, беспокойство

Day #25
add - прибавлять, присоединять
give - давать, дарить
apologize = apologise - извиняться, просить прощения
prevent - предотвращать, мешать
connect - соединять (ся), сочетать (ся)
best - лучше всего, больше всего
patience - терпение
guess - догадаться, полагать
write - писать
refer - упоминать

Day #26
careless - беззаботный, небрежный
suit - подходить
maximum - максимальный
style - стиль
office - офис
remember - помнить, вспоминать
describe - описывать
might - мочь (прош. вр. от may)
one - один
cruelty - жестокость

Day #27
uniform - форма, форменная одежда
expect - ожидать, надеяться
go back (to) - возвращаться
theirs - их
nervous - нервный
needle - игла
skill - умение, навык
die - умереть, скончаться
cheek - щека
storm - шторм, гроза

Day #28
straight - прямо
grateful - благодарный, признательный
all - весь, вся, все, целый
history - история
arrive - прибывать
mistake - ошибка
worse - худший
dare - осмеливаться, сметь
obvious - очевидный, ясный
common - общее, распространенное

Day #29
swing - качать (ся)
concerned - заинтересованный, беспокоящийся
trade - торговать
form - образовывать, формировать
concentrate - сосредоточивать (ся)
area - площадь, участок, пространство
before - впереди, вперед, прежде
think - думать, полагать
that - тот, та, то, те
thanks - спасибо

Day #30
neither - ни тот ни другой, ни один из двух
fence - забор
emphasize - подчеркивать, акцентировать
over - над, выше, через, по
proud - гордый
direction - направление
continue - продолжать (ся), оставаться
manner - манера, способ, метод
temperature - температура
take out - вынимать, брать с собой

Day #31
meet - встречать (ся), знакомиться
choice - выбор, отбор
brown - коричневый, бурый
complaint - жалоба, недовольство
custom - обычай, таможня
deliver - доставлять, разносить
every - каждый,  любой
boring - скучный
home - дом
risk - рисковать

Day #32
blow - веять, дуть
again - еще, вновь, опять
say - сказать, говорить
detail - деталь
control - управлять, контролировать
call - кричать, называть
fire - стрелять, выстреливать, увольнять
sorry - огорченный, сожалеющий
taste - вкус
shoot - стрелять

Day #33
divide - отделять (ся), разъединять (ся)
motion - движение
bored - скучающий
make into - переделывать, превращать во (что-л.)
read - читать
pile - куча, кипа
who - кто
appeal - призыв, обращение, привлекательность
long - долго, длительно
mark - отмечать, обозначать

Day #34
trick - обманывать, надувать
work up to - отрабатывать
bring up - приводить, приносить наверх
match - подходить, соответствовать
spin - крутить (ся), вертеть (ся)
rarely - нечасто, редко
letter - письмо, буква
region - область, регион
crowded - переполненный, битком набитый
cover - крышка, обложка

Day #35
matter - иметь значение, значить
ahead - вперед; впереди
come in - входить
declaration - декларация
once - один раз, раз
pipe - труба, трубопровод
its - его, ее
system - система
wrap - заворачивать,  завертывать
fetch - принести, добиваться

Day #36
colour - цвет, оттенок
spend - тратить, проводить
approval - одобрение, утверждение
message - сообщение, основная тема
exact - точный
stamp - марка, штамп
phone - звонить по телефону
actually - фактически, на самом деле
both - оба, обе
joke - шутить

Day #37
uncertain - неопределенный, неуверенный
safe - безопасный
excuse - извинение
squash - раздавливать, сжимать
mad - сумасшедший, ненормальный
among - между, посреди, среди
belief - вера, доверие
minimum - минимальный
pain - боль, страдание
offence - нарушение, преступление

Day #38
strong - сильный
since - с тех пор
let - позволять, разрешать, сдавать внаем
basically - в своей основе; по существу
learn - учиться, учить (что-л.)
support - поддерживать
cheque - чек
contrast - сопоставлять, сравнивать (with)
praise - хвалить
shut - закрывать (ся)

Day #39
key - ключ
memory - память
achievement - достижение, успех
tour - путешествие, экскурсия
major - более важный, больший
hold - захвт, рукоятка
would - выражает желание
bar - бар, брусок, барьер
dangerous - опасный
never - никогда

Day #40
cross - перекрещивать, пересекать (ся)
cope - справиться, выдержать
consist - состоять, составлять из (of)
sink - раковина
against - прямо напротив, лицом к
platform - платформа, трибуна
mine - шахта, мина
neck - шея, воротник, горлышко
respect - уважение
fat - толстый, упитанный

Day #41
sticky - клейкий, липкий
worried - озабоченный
connected - связанный с кем-л., чем-л.
store - магазин, склад, запас
crisis - кризис
mood - настроение
represent - представлять, изображать
book - книга
be - быть
suit - костюм

Day #42
gas - газ
aim - намерение, цель
generally - обычно, как правило
public - общественный, государственный
free - свободный, бесплатный
look up - искать (что-л. в справочнике)
sick - больной
break up - крошиться на мелкие части
tight - тесный, тугой
confuse - смешивать, спутывать

Day #43
or - или
slice - ломтик
moral - моральный, нравственный
hurry - суета, спешка
without - без
dream - сон, мечта
greeting - приветствие
nonsense - абсурд, ерунда
spot - место, пятно
please - пожалуйста!

Day #44
glad - довольный, рад
closely - близко, вплотную
shopping - посещение магазина
majority - большинство
keep out - не допускать, не впускать
note - записка, нота
blame - упрек, осуждение
hold out - протягивать, предлагать
trust - вера, доверие
violence - жестокость, насилие

Day #45
reason - причина, смысл
beautiful - красивый
schedule - список, перечень
past - мимо
emotion - чувство, эмоция
firm - твердый, стойкий
unable - неспособный
excited - взволнованный, напряженный
sad - грустный, печальный
scrap - клочок, кусочек

Day #46
build - строить
laugh - смеяться, рассмеяться
damp - влажный, сырой
organize - организовывать, планировать
environment - окружение, окружающая среда
mess - беспорядок, неприятность
nose - нос
turn back - обернуться, возвращаться
after - после, потом
raw - сырой, необработанный

Day #47
summer - лето
underneath - вниз, внизу, ниже
exhibition - выставка
share - доля, часть
just - только что, точно, только
breakfast - завтрак
bad - плохой
stretch - тянуть (ся), растягивать (ся)
several -  несколько
cry - плакать

Day #48
authority - власть, полномочие, авторитет
project - проект
duty - обязанность
fierce - свирепый, лютый
soil - грунт, почва
which - который, какой
tooth - зуб
move - движение, развитие
work on - продолжать работать
whether - ли, или

Day #49
right - право, правда
fasten - прикреплять, застегивать (ся)
about - кругом, повсюду, приблизительно
first - первый, сначала
medium - средний, промежуточный
later - более поздний
dull - скучный, тупой
recover - выздоравливать, восстанавливать(ся)
acceptable - приемлемый; допустимый
any - нисколько, сколько-нибудь, ничуть

Day #50
upset - расстроенный, огорченный
complain - жаловаться, выражать недовольство
company - компания
range - ряд, линия
air - воздух, атмосфера
control - надзор, контроль
act - действовать, поступать
advanced - передовой, продвинутый
leave - покидать, оставлять
practice - практика

Day #51
relief - облегчение
street - улица
increase - возрастание, рост
claim - требование, претензия
complete - завершать, укомплектовывать
fold - загибать, складывать
sting - жалить
order - заказывать, приказывать
determined - решительный
left - левая сторона

Day #52
urgent - срочный, неотложный
silent - молчаливый, тихий
embarrassing - стеснительный, смущающий
often - часто
flavour - вкус, аромат
idea - идея
behind - сзади, позади, после, за
light - свет, лампа
thank you - спасибо
copy - копия

Day #53
final - завершающий, заключительный
expression - выражение, выражение (лица)
smoke - дым
sale - продажа, распродажа
tip - наклонять (ся), опрокидывать
seat - сиденье, место
hate - ненавидеть
early - ранний, рано
lay - класть, положить
come off - отрываться, отделываться

Day #54
bin - ящик
wire - проволока, провод
rest - остаток, отдых
necessary - необходимый, нужный
somehow - так или иначе, как-нибудь
bottom - дно, низ
help - помогать
perhaps - может быть, возможно
pressure - давление, воздействие
joke - шутка

Day #55
exploration - исследование, изучение
path - тропинка, дорожка
tape - (магнитная) лента
combine - соединяться, объединять(ся)
though - хотя, однако
hospital - больница
punishment - кара, наказание
wind - виться, изгибаться, заводить
walk - прогулка
material - материал

Day #56
matter - дело, вопрос, причина
near - ближний, близкий
fast - быстрый, скорый
someone - кто-нибудь, кто-то
go out - выйти, выходить
journey - путешествие, поездка
certain - определенный, уверенный
apply - обращаться(с просьбой), применять(ся)
contribute - способствовать, вносить вклад
union - объединение, союз

Day #57
stupid - глупый, тупой
temper - характер, настроение
maybe - может быть
too - слишком, тоже
decide - решать (ся), принимать решение
music - музыка
reply - отвечать, отзываться
tone - тон, звук
mother - мама
collect - собирать, коллекционировать

Day #58
climb - карапкаться, лазить
far - далеко
wherever - где бы ни, куда бы ни
calm - спокойный, мирный
bridge - мост
arrange - приводить в порядок, расставлять
minute - минута
not - не, нет, ни
everybody - каждый, всякий (человек), все
relationship - родство, взаимоотношение

Day #59
bite - укус
mention - упоминать
stone - камень
deal - сделка, соглашение
harm - вред; зло
recommend - рекомендовать
present - подарок
disappear - исчезать
many - много
police - полиция

Day #60
extra - добавочный, дополнительно
information - информация
more - больше, еще
intend - планировать, предназначаться
government - правительство
according to - в соответствии с, согласно
event - событие
effort - усилие, попытка
eat - есть, кушать
pity - жалость

Day #61
hide - прятать (ся), скрывать (ся)
sleep - сон
persuade - убеждать
world - мир
straight - прямой
become - становиться
live - живой
relation - связь, родственник
pause - останавливаться
smooth - гладкий, ровный

Day #62
than - чем
pretty - достаточно, довольно
get up - вставать, подниматься
solve - решать, разрешать
difficult - трудный, сложный
tip - кончик, чаевые
handle - управлять, регулировать, трогать
design - разрабатывать, проектировать
ball - шар, мяч
impression - впечатление

Day #63
live - жить
outside - снаружи, вне, за пределами
across - поперек, сквозь, через
interview - беседа, интервью
unite - соединять (ся), объединять (ся)
congratulations - поздравление
doubt - сомнение
cry - плач
lock - замок, локон
bring down - свалить, снизить (цену)

Day #64
rain - дождь
sure - конечно, безусловно
crazy - ненормальный, псих
forever - навсегда, всегда
only - единственный
defend - защищать (ся)
far - дальний, далекий
juice - сок
back - спина, спинка, зад, задняя часть
payment - платеж, оплата

Day #65
reserve - резервировать, сберегать
artificial - искусственный, ненатуральный
spring - отскочить, распрямиться
need - нуждаться, требоваться
confident - уверенный
fast - быстро, скоро
wait - ждать
turn down - убавить, отказывать
head - голова
afford - быть в состоянии, предоставлять

Day #66
responsibility - ответственность
mind - возражать, иметь что-л. против
yours - ваш, твой
length - длина, расстояние
capital - столица
strength - сила, прочность
nothing - ничего, ничто
surprised - удивленный
point - точка, цель, место
pride - гордость

Day #67
promise - обещание
sight - вид, зрение, достопримечательность
like - подобный, похожий
afraid - испуганный
stand - стоять
loan - заем, ссуда
drop - капля, падение
rent - брать в аренду, сдавать в аренду
drive - везти, ездить, управлять (автомобил)
bush - куст

Day #68
quantity - количество
also - тоже, также, к тому же
sense - чувство, смысл
make up - выдумывать
direct - руководить, направлять
reduction - сокращение, понижение
brother - брат
brief - короткий, недолгий
occasional - случайный
extremely - чрезвычайно, крайне

Day #69
fear - бояться
make - делать, создавать
ours - наш
rather - достаточно, весьма
minimum - минимум, минимальное количество
offend - обижать, раздражать
argument - довод, аргумент
belong - принадлежать, соответствовать
fit - подходить, соответствовать
general - главный, основной

Day #70
thirsty - испытывающий жажду
level - уровень, степень
watch - наблюдать, смотреть
shade - тень, полумрак
listen - слушать
legal - легальный, законный
bus - автобус
wash - мытье, мойка, стирка
prefer - предпочитать
complete - полный, укомплектованный

Day #71
send - посылать, отправлять
married - женатый, замужняя
usual - обыкновенный, обычный
chief - главный, основной
university - университет
male - мужской, мужского пола
rough - грубый
once - однажды, когда-то
truth - правда
while - пока,  в то время как,  хотя

Day #72
term - срок, семестр
creature - создание, творение
night - ночь
part - доля, часть
warn - предупреждать, предостерегать
flow - течь, струиться
year - год
breathe - дышать
fight - драться, сражаться
date - дата

Day #73
circle - круг, окружность
whistle - свистеть
know - знать
accommodation - помещение, жилье
attempt - попытка, проба, опыт
possibly - возможно, может быть
table - стол
benefit - выгода, прибыль
factory - завод, фабрика
ground - земля

Day #74
born - родившийся
proper - присущий, правильный
where - где, куда, откуда
children - дети
guess - предположение, догадка
justice - справедливость, правосудие
take - брать
borrow - одалживать, занимать
voice - голос
nature - природа

Day #75
side - боковой
middle - средний, центральный
fly - летать
pretty - хорошенький, симпатичный
secret - секретный, тайный
sign - знак; символ
taste - пробовать (на вкус)
agree - соглашаться
cough - кашлять
suddenly - вдруг, внезапно

Day #76
receive - получать
mouth - рот
health - здоровье
today - сегодня, в наши дни
mine - мой, моя, мое
poor - бедный
about - о, насчет, на тему, касательно
floor - пол, этаж
question - расспрашивать, допрашивать
guilty - виновный, виноватый

Day #77
even - даже
operate - действовать, функционировать
count - считать, подсчитывать
turn - поворачивать (ся)
for - для, в течение
famous - знаменитый, известный
tradition - традиция
shine - сиять, светить (ся), блестеть
react - реагировать, отзываться
special - особый, специальный

Day #78
deserve - заслуживать
shrink - уменьшать (ся), сокращать (ся)
software - компьютерные программы
sort - сортировать, классифицировать
consult - советоваться, консультироваться
measure - измерять, иметь размер
recognize - признавать, узнавать
waste - излишняя трата, отбросы
thing - вещь, предмет
we - мы

Day #79
frightened - испуганный
undo - развязывать, расстегивать
murder - убийство
bag - сумка
convince - убеждать, уверять
partner - партнер, супруг (а)
realize - понимать, осознавать
enough - достаточно, достаточный
see - видеть
less - меньше, менее

Day #80
hello - привет!
reply - ответ, отклик
interested - заинтересованный, интересующийся
convenient - удобный, близкий
pretend - притворяться
well - здоровый
get on - садиться (в машину)
test - испытывать, тестировать
practical - практический, практичный
father - отец

Day #81
dream - сниться, мечтать
along - в том же направлении
perfect - совершенный
your - ваш, твой
exaggerate - преувеличивать
criticism - критика
discovery - открытие
gap - щель, промежуток
discover - обнаруживать, открывать
brush - щетка

Day #82
accidental - случайный
notice - объявление, афиша
switch - выключатель
birth - рождение
war - война
community - сообщество
supply - поставка, предложение
city - город
herself - сама, себя
lift - поднимать (ся)

Day #83
lend - одалживать, давать взаймы
value - ценность, стоимость
peace - мир
float - плавать, держаться на  воде
smell - запах, обоняние
skin - кожа, кожура
talk back - спорить, возражать
rub - тереть (ся)
purpose - цель, намерение
corner - угол

Day #84
talk - разговор, беседа
run out - кончаться
close - близкий
dark - темный
top - верхушка, верх, крышка
anything - что-нибудь, ничто, ничего
face - быть обращенным к,  стоять лицом к
recovery - выздоровление, восстановление
keep up - поддерживать, продолжать
kind - добрый

Day #85
join - соединять, объединять
definite - ясный, точный
wrong - неправильный, неверно
direct - прямой
above - наверху, вверху, выше, над
into - в (о), на
paper - бумага
get out - выходить, вылезать
bunch - связка, пучек
laugh - смех

Day #86
substance - вещество, субстанция
black - черный цвет
comfort - комфорт
odd - странный, необычный
total - абсолютный, весь, всеобщий
cause - послужить причиной/поводом для ч-л.
process - процесс
have - иметь
combination - сочетание, комбинация
impatient - нетерпеливый

Day #87
responsible - ответственный
spray - брызгать, распылять
get away - уходить
face - лицо
interfere - вмешиваться, повлиять
sail - плавать, совершать плавание
go up - подниматься, идти вверх
public - публика, общественность
fact - обстоятельство, факт
damage - повреждать, портить

Day #88
encourage - поощрять, поддерживать
neither - также не
hurt - раненый
badly - плохо
behaviour - поведение
worst - наихудший
talk - разговаривать, болтать
trap - капкан, ловушка, обман
anyway = anyhow - так или иначе, как-нибудь, все равно
study - изучение, исследование, кабинет

Day #89
off - несвежий, маловероятный
related - связанный, родственный
they - они
invite - приглашать, звать
brain - мозг, интеллект
risk - риск
town - город
limit - граница, предел
run away - убежать
protest - протест, несогласие

Day #90
injury - вред, рана
share - делить (ся), разделять
culture - культура
private - частный
lunch - обед, ленч
run into - наталкиваться, сталкиваться
bright - яркий
march - маршировать, вышагивать (нервно)
improve - улучшать (ся), совершенствовать (ся)
dead - мертвый

Day #91
blue - голубой, синий
wish - желание
none - никакой, ни один, никто
smell - пахнуть, нюхать
measure - мера, мероприятие
tall - высокий
calmly - спокойно, невозмутимо
exercise - упражнение, тренировка
arm - рука (от кисти до плеча)
shelter - приют, убежище

Day #92
put - класть, положить
feeling - ощущение, чувство
reliable - надежный, верный
downstairs - расположенный в нижнем этаже, вниз
copy - копировать
look after - присматривать, ухаживать за
release - освобождать (ся),  отпускать
visit - навещать, посещать
habit - обычай, привычка
average - среднее, средний

Day #93
hardly - вряд ли, почти не, едва
plenty - множество, избыток
principle - принцип
disagree - не совпадать, противоречить
same - тот (же) самый, одинаковый
treatment - лечение,обращение
blame - осуждать
fall - падение
furniture - мебель
fine - превосходный, тонкий

Day #94
stir - размешивать, шевелить (ся)
formal - официальный, формальный
sea - море
correct - правильный, соответствующий
shoulder - плечо
track - тропинка, трек
and - и, а, но
satisfied - удовлетворенный, довольный
easy - легкий
instead - вместо, взамен

Day #95
advantage - преимущество
especially - особенно, в особенности
lead - вести, сопровождать, управлять
only - только, исключительно
beside - рядом с, возле, около
regular - регулярный, правильный
number - число, номер, количество
slowly - медленно
mystery - тайна, загадка
quite - совершенно, вполне, совсем

Day #96
meal - прием пищи, еда
bit - кусочек
buy - покупать
position - положение, место
drink - пить
frame - рама, оправа, каркас
trouble - беспокойство, неприятность
ashamed - пристыженный
think over - обдумывать
uncomfortable - неудобный

Day #97
height - высота, рост
deaf - глухой
really - действительно, в самом деле
phone - телефон
still - до сих пор, все еще, по-прежнему
teach - преподавать, обучать
there - там, туда
offer - предлагать
quickly - быстро
load - груз

Day #98
progress - прогресс
communicate - сообщать, передавать
underneath - вниз, внизу, ниже, под
under - при, под
fire - огонь, пожар
find - находить
yes - да
sudden - внезапный, неожиданный
result - результат
loss - потеря, гибель

Day #99
concerning - касательно, относительно
fortunate - счастливый, удачливый
touch - прикасаться, трогать
break - ломать, разрушать
border - граница
difference - разница, отличие
vanish - исчезать, пропадать
begin - начинать (ся)
spring - весна
quick - быстрый, скорый

Day #100
slide - скользить, засовывать
stick - приклеивать (ся), втыкать
interest - интерес
welcome - приветствовать
estimate - оценивать, исчислять
can - мочь, быть в состоянии
equal - равный, одинаковый
round - вокруг, кругом
squeeze - выжимать (ся), выдавливать
morning - утро

Day #101
comment - комментарий, замечание
week - неделя
view - точка зрения, мнение, пейзаж
tax - налог, пошлина, сбор
rate - показатель, степень, темп
spread - распространять (ся), простираться
sharp - острый, резкий
finally - наконец, в конце концов
wander - бродить, блуждать
window - окно

Day #102
when - когда
narrow - узкий
most - больше  всего, почти все
design - проект, намерение, дизайн
judge - судья
introduce - знакомить, представлять
to - к, в, на, до
suppose - допускать, полагать
wet - мокрый
surface - поверхность

Day #103
vision - зрение, представление
soft - мягкий, нежный
deliberate - намеренный, предумышленный
clue - ключ (к разгадке), улика
preparation - подготовка, приготовление
programme - программа
fear - боязнь,  страх
much - много, очень
smile - улыбка
punish - наказывать, штрафовать

Day #104
opponent - противник, оппонент
wave - волна, взмах
physical - физический, материальный
enjoy - получать удовольствие, наслаждаться
cheap - дешевый
mind - ум, мнение, воспоминание
go down - опускаться, садиться
why - почему
forget - забывать
failure - неспособность, несостоятельность

Day #105
call up - вызывать, звонить (по телефону)
spare - запасной, лишний
protection - защита, охрана
go off - выстреливать (об оружии), взрываться
somewhere - где-то, где-нибудь, куда-нибудь
book - вносить в книгу, регистрировать
develop - развивать (ся)
body - тело
action - действие, поступок
tap - (по) стучать, (по) хлопать

Day #106
hang - вешать, висеть
well - хорошо
activity - деятельность
everyone - каждый, всякий (человек), все
unit - часть, единица измерения
course - курс, блюдо
foreign - иностранный; заграничный
modern - современный
clothes - одежда
full - полный

Day #107
old - старый
picture - картина, рисунок
intelligent - сообразительный, понятливый
serious - серьезный, важный
discussion - дискуссия
must - должен, обязан
regret - сожалеть
soak - впитывать (ся)
include - заключать, включать в себя
square - квадратный

Day #108
congratulate - поздравлять
story - рассказ, история
step - шаг, след
noisy - шумный, неспокойный
mass - масса, множество
nerve - нерв, мускул
decision - решение
stranger - незнакомец
no - не, нисколько не
tool - (рабочий) инструмент

Day #109
smile - улыбаться
otherwise - иначе, во всем остальном
perform - выполнять, выступать
possession - владение, обладание
splash - брызгать (ся), плескать (ся)
rise - подниматься
content - довольный
split - раскалывать (ся), разделять (ся)
mark - знак, пятно, оценка
deliberately - сознательно,обдуманно

Day #110
ring - кольцо, круг
previous - предыдущий, предшествующий
rush - спешка, суета
original - начальный, оригинальный
call back - перезванивать кому-л.
replace - заменять, замещать
change - перемена, изменение
plan - планировать
win - победить, выиграть
battery - батарея, аккамулятор

Day #111
issue - вопрос (проблема), выпуск
near - близко, около, возле, рядом
will - выражает обещание, намерение
place - пространство, место, площадь
coffee - кофе
confusing - сбивающий с толку
use - употребление, использование
hollow - пустой, впалый
row - ряд, линия
violent - насильственный

Day #112
sink - тонуть, погружаться, опускаться
ourselves - сами, себя
present - присутствующий, настоящий
fit - подходящий, соответствующий
she - она
refuse - отказать (ся), отклонять
move - двигать (ся), переезжать
separate - отдельный
swim - плавать
organization - организация

Day #113
nearly - почти
provide - снабжать, обеспечивать
bread - хлеб
attitude - позиция, отношение
judge - судить, выносить приговор
house - дом
right - правильно
produce - производить, создавать
regularly - регулярно
autumn - осень

Day #114
tonight - сегодня вечером
weather - погода
bath - ванна
me - меня, мне
compete - состязаться, соперничать
look - смотреть, следить
speak - говорить, разговаривать
absolutely - совершенно, безусловно
building - здание, сооружение
rush - мчаться, торопить

Day #115
band - оркестр, лента, полоса
development - развитие
holiday - праздник, отпуск
flat - ровно, плоско
excellent - отличный
treat - радость, удовольствие
instruction - инструкция, правило
clear - очищать, осветлять
female - женского пола, женский
scheme - проект, план

Day #116
keep away - держать (ся) в отдалении, избегать
ever - всегда, когда-либо
come down - спускаться, опускаться
stamp - топать ногой, штамповать
at - в, на, за, при, у, около
worry - беспокоить (ся)
experience - (жизненный) опыт, опыт работы
feed - кормить
popular - популярный
talk into - уговорить, убедить

Day #117
education - образование, обучение
science - наука
pleasant - приятный, радостный
plenty - вполне, довольно
season - сезон, время года
distant - дальний, далекий
thought - мысль, размышление
play - играть
waste - тратить
anybody - кто-нибудь, никто, любой

Day #118
sleep - спать
obtain - получать, добывать
exactly - точно
pause - пауза
part - расставаться, разделяться
reduce - понижать, сокращать
run - бег
unhappy - несчастливый, несчастный
short - короткий, низкий
under - вниз, ниже, под

Day #119
happy - счастливый, довольный
land - приземляться, высаживать (на берег)
ride - ехать
state - состояние, государство
anyone - кто-нибудь, никто, любой
discuss - обсуждать
exist - существовать, иметься в природе
quiet - тихий, бесшумный
nowhere - нигде, никуда
check - контроль, проверка

Day #120
behind - задний
similar - подобный, похожий
that - так, до такой степени
clean - чистить
country - страна, деревня
drawing - рисунок, рисование
favourite - любимый
through - свободный
think through - продумывать
gift - подарок

Day #121
own - свой, собственный
unless - если не, пока не
scream - крик
fresh - свежий
frequent - частый
aware - знающий, осведомленный
slow - медленный
how - как
our - наш
with - с

Day #122
improvement - улучшение, усовершенствование
section - секция
occur - происходить, случаться
shake - трясти (сь), встряхивать
ill - больной
wave - махать, колыхаться
check - проверять, сверять
still - тихий, неподвижный
plate - тарелка
score - выигрывать

Day #123
command - команда, распоряжение
lost - разрушенный, потерянный
down - вниз, внизу
sound - звук
catch - ловить, поймать
independent - независимый, самостоятельный
closed - закрытый, запертый
thank - благодарить
train - тренировать (ся), обучать (ся)
surprising - неожиданный, внезапный

Day #124
go on - продолжать, случаться
zero - ноль
sore - боль
permission - позволение, разрешение
class - класс, группа
tomorrow - завтра
shadow - тень
large - большой, крупный
already - уже
think of - подумать, предполагать

Day #125
objection - возражение, протест
person - человек, личность
shop - делать покупки
case - случай, чехол
serve - подавать, обслуживать, служить
profit - прибыль
cold - холодный
left - налево, слева
hold up - останавливать, грабить
relax - расслабляться, отдыхать

Day #126
exchange - обмен
busy - занятой, деятельный
scream - кричать, вопить
pronounce - произносить, заявлять
spoil - портить (ся),  баловать
doubt - сомневаться
time - время
emergency - непредвиденный случай
home - дома
match - спичка, матч

Day #127
contact - контакт, соприкосновение
appearance - внешность, появление
take away - убирать, отнимать
love - любить
movement - движение, передвижение
possibility - вероятность, возможность
forgive - прощать
classroom - классная комната, аудитория
hair - волосы
another - другой, еще один (такой же)

Day #128
nor - и... не, также... не
break in - вламываться, врываться
left - левый
inform - сообщать, информировать
friendly - дружественный
simple - простой, легкий
avoid - избегать, остерегаться, уклоняться
him - ему, его
enter - входить, поступать
rubbish - мусор, ерунда

Day #129
arrival - прибытие (at, in; from)
oil - нефть, масло
minority - меньшинство
watch - часы (наручные), наблюдение
trade - торговля
effect - результат, следствие
computer - компьютер
good - хороший
exchange - обменивать
contain - содержать, вмещать

Day #130
flat - плоский, ровный
honest - честный
trap - задерживать, останавливать
walk - гулять, идти (пешком)
reaction - реакция
answer - отвечать, откликаться
collection - коллекция
attract - привлекать, притягивать
party - вечеринка, партия
bottom - нижний

Day #131
kick - ударять ногой, пинать
lose - терять, проигрывать
inquire - осведомляться, узнавать
room - комната
understand - понимать
bill - счет
possible - вероятный, возможный
normal - нормальный, обыкновенный
manage - руководить, управлять
negative - отрицательный, негативный

Day #132
label - ярлык, этикетка
as - в качестве, как, как например, т.к.
force - сила
word - слово
occasion - случай, повод
pupil - ученик
respect - уважать
guard - охрана, защита
front - передняя сторона чего-л
such - такой

Day #133
entrance - вход
transparent - прозрачный, просвечивающий
thin - тонкий, редкий
unkind - злой, недобрый
within - внутри, в пределах
grow - расти, вырастать
favour - одолжение, услуга
upon = on - на
love - любовь
before - прежде чем, до того как

Day #134
come - приходить, подходить
later - позже
target - цель, мишень
various - различный, разнообразный
dance - танцевать
each - каждый, всякий
wide - широко
report - доклад, отчет
report - сообщать, докладывать
reject - отклонять, отказывать (ся)

Day #135
approve - одобрять (что-л.- of), утверждать
weigh - весить, взвешивать (ся)
game - игра
race - гонка, раса
glass - стекло, стакан
poison - яд
branch - ветвь, отрасль
delicate - нежный
rich - богатый
division - деление, разделение

Day #136
mix - смешивать (ся), соединять
grade - степень, класс, сорт
luck - везение, удача, успех
unusual - необычный, редкий
basic - составляющий основу, основной
century - столетие, век
store - запасать, хранить
field - поле
sensible - благоразумный, здравомыслящий
false - неверный, ошибочный

Day #137
disturbing - беспокоящий, волнующий
mail - почта
ring - звонить, звенеть
burst - лопаться, взрываться
entry - вход, проход
tune - мелодия
come out - выходить
because - потому что, так как
production - изготовление, продукция
bring back - приносить обратно, возвращать

Day #138
grand - большой, замечательный
comfortable - комфортный, удобный
advice - совет
take off - снимать одежду, взлетать
search - поиск, розыск
enthusiastic - восторженный, увлеченный
attention - внимание, внимательность
instant - мгновенный, растворимый
heart - сердце
challenge - (сложная) проблема

Day #139
but - а, но, однако
subject - предмет, тема
steady - устойчивый, постоянный
correction - исправление, корректирование
ignore - игнорировать, пренебрегать
warm - теплый
correct - исправлять, корректировать
carry - носить
press - нажимать, сжимать
sometimes - иногда

Day #140
brush - чистить щеткой, причесывать
order - порядок, заказ в ресторане
point - указывать, показывать
fair - честный, справедливый, светлый
yesterday - вчера
charge - назначать, запрашивать цену
guide - вести, руководить
defeat - одержать победу
bear - терпеть, выносить
further - дальше, дальнейший

Day #141
earn - зарабатывать, заслуживать
by - близко, возле, около, рядом
food - пища, еда
importance - важность, значимость
whistle - свисток
wheel - колесо
end - конец
thick - толстый, густой
situation - положение, ситуация
broken - разбитый, сломанный

Day #142
do - делать
kill - убивать
plastic - пластик, пластмасса
road - дорога
recent - недавний, последний
steam - пар
couple - пара, два, двое
during - в течение, во время
this - этот, эта, это
exam - экзамен

Day #143
energy - энергия, сила
impressed - пораженный
whole - весь, целый,  в целом
keep from - удерживать (ся), воздерживаться
OK or okay - хорошо, правильно
unfair - несправедливый
now - сейчас
lead - преимущество, поводок (для собаки)
disapprove - осуждать, не одобрять
fairly - должным образом, довольно

Day #144
should - выражает долженствование
miss - промах, неудача, отсутствие
work out - решать, разрабатывать
pocket - каман
destroy - разрушать, ликвидировать
here - здесь
apparently - очевидно, по-видимому
surprise - сюрприз, удивление
cool - прохладный, свежий
enjoyable - приятный

Day #145
smart - нарядный, шикарный
consider - рассматривать, считать
pay - платить
cost - цена, стоимость, расходы
satisfactory - удовлетворительный, достаточный
towards - по направлению к, по отношению к
back - поддерживать, подкреплять
basis - базис, основа, основание
fashion - мода
mistake - ошибаться

Day #146
ready - готовый
thorough - тщательный, исчерпывающий
come from - приходить откуда-л.
concentration - концентрация, сосредоточенность
whoever - кто бы ни,  который бы ни,  любой
sky - небеса, небо
very - очень
then - затем, потом
reasonable - разумный, благоразумный
tidy - убирать, приводить в порядок

Day #147
dear - дорогой, милый
dance - танец
shape - форма, очертание
succeed - удаваться
last - длиться, сохраняться
genuine - истинный, реальный
slightly - незначительно, несущественно
skirt - юбка
run over - переехать, задавить
record - записывать

Day #148
press - пресса
gradually - постепенно
alone - единственный, одинокий, одиноко
regard - внимание, уважение
character - характер, действующее лицо
roll - катить (ся),  вращаться
onto - на, в
snow - снег
positive - уверенный, позитивный
eager - страстно желающий, жаждущий

Day #149
error - заблуждение, ошибка
separate - разделять, расставаться
sweep - мести, выметать
bye - до свидания
threaten - угрожать
goodbye - до свидания!
talk out of - отговорить, разубедить
of - от, об, о, из
wall - стена
secret - секрет, тайна

Day #150
drive - езда
answer - ответ
ago - тому назад
amount - величина, количество
demonstrate - показывать, демонстрировать
clear - чистый, ясный
create - создавать, порождать
different - различный, разный
attempt - пытаться, стараться, стремиться
convincing - убедительный

Day #151
difficulty - трудность
school - школа
birthday - день рождения
block - блок, квартал
deep - глубокий
proof - подтверждение, доказательство
wonder - удивляться, интересоваться
himself - сам, себя
admit - допускать, соглашаться
influence - влиять, воздействовать

Day #152
finger - палец (на руке)
statement - заявление, утверждение
happen - случаться, происходить
advise - советовать, советоваться
promise - обещать
interrupt - прерывать, прекращать
although - хотя, несмотря на то, что
trip - путешествие, поездка
appeal - обращаться, взывать (to - к)
call - тефонный звонок, вызов, крик

Day #153
turn - очередь, поворот
familiar - хорошо знакомый, привычный
other - другой
wipe - вытирать, стирать
remain - оставаться, находиться
fill - наполнять (ся)
it - это, он, она, оно
light - загораться, освещать
sort - вид, сорт, тип
forward - вперед, спереди

Day #154
swimming - плавание
switch - переключать
hope - надеяться
late - поздний, последний, поздно
sound - звучать
centre - центр
wild - дикий
unlikely - маловероятный, невероятно
sing - петь
post - почта

Day #155
type - тип, класс, род
hungry - голодный
freedom - свобода
mysterious - таинственный, загадочный
before - перед, до, раньше
coat - пальто
drop - ронять, падать
listen for - прислушиваться
star - звезда
winter - зима

Day #156
attractive - заманчивый, привлекательный
ocean - океан
new - новый
chin - подбородок
test - тест, проверка
anxious - озабоченный, беспокойный
moment - момент, мгновение
interview - интервьюировать
up - вверх, наверх, наверху, на
female - самка,  женская особь

Day #157
accidentally - случайно, нечаянно
cut - разрез, порез
but - кроме, за исключением, исключая
fond - нежный, любящий
probably - вероятно, наверное
foot - ступня, подножие
wish - желать, хотеть
practise - практиковать (ся), тренироваться
club - клуб
politics - политика

Day #158
dress - платье, одежда
sign - подписывать (ся)
fortunately - к счастью
instrument - инструмент, прибор
available - доступный, (при)годный, полезный
lie - лежать
typical - типичный
burn - гореть, пылать
immediate - немедленный
however - однако, тем не менее

Day #159
dish - блюдо
end - кончать, завершать
variety - разновидность, разнообразие
on - включенный, действующий
natural - естественный, природный
degree - степень, градус
polite - вежливый
study - изучать, заниматься
whenever - всякий раз когда,  когда бы ни
family - семья

Day #160
almost - почти; едва не
cinema - кинотеатр
total - целое, сумма, итог
declare - заявлять, заявлять
content - содержимое, содержание
shock - удар, толчок, шок
some - какой-либо, какой-нибудь, несколько
lock - запирать ключом, блокировать
come round - заходить ненадолго, заглянуть
account - счет, расчет, подсчет

Day #161
affect - (воз)действовать, влиять
abroad - за границей, за границу
somebody - кто-нибудь, кто-то
else - еще, кроме
trip - спотыкаться, ставить подножку
tread - наступать, топтать
evidence - доказательство, основание
my - мой, моя, мое
afterwards - впоследствии, позднее
fun - шутка, веселье

Day #162
maintain - поддерживать, удерживать
desperate - безнадежный; бесперспективный
scrape - скоблить, обдирать, царапать
object - предмет, объект, цель
in - внутри, внутренний
work - работать, производить
treat - обращаться, относиться, лечить
side - сторона
something - кое-что, что-нибудь, что-то
break down - разрушать, разбивать на кусочки

Day #163
stop - останавливать (ся)
ought - выражает долженствование
dry - сухой
better - лучший, наилучший
the - определенный артикль
opposite - напротив, против
conversation - разговор, беседа
shut - закрытый
high - высоко
break through - прорваться, пробиться

Day #164
away - прочь, вдали
translate - переводить
pattern - модель, система
come up - подниматься, возникать
pass - проходить, проезжать, передавать
mess - производить беспорядок
spill - проливать (ся), рассыпать (ся)
record - запись, рекорд
considering - учитывая, принимая во внимание
stop - остановка

Day #165
contents - содержимое
imagination - воображение; фантазия
save - спасать, охранять
turn over - переворачивать (ся), переключить
human - людской, человеческий
hard - жесткий, твердый
second - второй
survive - пережить, выжить
fork - вилка
base - база, базис, основа, основание

Day #166
could - прош. вр. от can
quality - качество
news - известие, новость
tired - усталый
plain - чистый, одноцветный, понятный
empty - пустой
pleasure - удовольствие
commit - совершать (преступление)
print - печатать
ability - способность, возможность

Day #167
immediately - немедленно, сразу
mend - чинить, ремонтировать
top - верхний, основной
emphasis - важность, значимость
future - будущее
door - дверь
way - дорога, путь, направление
slip - поскользнуться
church - церковь
give out - раздавать, распределять

Day #168
lower - нижний, низший
personal - личный
task - задание, задача
identify - опознавать, идентифицировать
show - шоу, показ
stare - вглядываться, уставиться
them - им, их
travel - путешествовать
increase - возрастать, увеличивать (ся)
insist - настаивать, утверждать

Day #169
official - должностное лицо
lesson - урок
doctor - врач, доктор
sell - продавать
flow - течение, поток
safety - безопасность, сохранность
start - начинать
now - теперь
likely - вероятный, возможный
give back - возвращать, отдавать

Day #170
get - получить
innocent - невинный, непорочный
feature - особенность, характерная черта
bound - связанный
unlucky - несчастливый, неудачный
card - карточка
whatever - все что, что бы ни
plant - растение, завод
certainly - конечно, естественно
standard - стандарт

Day #171
settle - улаживать,поселить(ся), устроить(ся)
beginning - начало
awake - не спящий, проснувшийся
start - начало
explain - объяснять, разъяснять
repeat - повторять
butter - масло
size - размер
fail - потерпеть неудачу, не сбыться
people - люди

Day #172
dress - одевать (ся), наряжать (ся)
conduct - сопровождать, сопутствовать
recently - недавно
square - квадрат, площадь
jump - прыгать
steal - воровать, красть
wake - просыпаться, будить
argue - спорить
wear - носить (одежду)
noise - шум, грохот

Day #173
lucky - счастливый, удачный
deep - глубоко
everything - всё
disappointed - разочарованный
sit - сидеть, садиться
her - ее
communication - коммуникация, связь
look back (on) - оглядываться
sentence - предложение, приговор
knowledge - знание

Day #174
mixture - смешивание, смесь
long - длинный
water - вода
method - метод, способ
until - до, (до тех пор) пока (не)
properly - должным образом, надлежаще
naturally - естественно
twist - крутить, сплетать (ся), обхватывать
great - большой, огромный
list - список, перечень

Day #175
little - мало, немного
tend - иметь тенденцию, стремиться
set - набор, комплект
service - служба, сервис
bang - удар, стук
crowd - толпа
together - вместе
curious - любопытный, любознательный
break into - вламываться, внезапно начинать
able - знающий, умелый, способный

Day #176
dry - сушить (ся), сохнуть
ordinary - обычный, обыкновенный
choose - выбирать
owe - быть должным, быть обязанным
wide - широкий
stiff - жесткий, плотный
go - идти, ходить
friend - друг
generous - щедрый, великодушный
work - работа

Day #177
group - группа
depend - зависеть, находиться в зависимости
board - доска
rescue - спасать
open - открытый
claim - требовать, предъявлять требования
yet - еще, уже
take over - принимать дела от другого
meeting - встреча, собрание
close - закрывать (ся)

Day #178
successful - удачный, успешный
seem - казаться
debt - долг
suggest - предлагать, советовать
kind - сорт, вид
bite - кусать (ся)
so - так, таким образом, также
flood - заливать, затоплять
law - закон
peaceful - мирный, миролюбивый

Day #179
from - от, из, с
inside - внутренний, внутри
slight - легкий, незначительный
rare - редкий, нечастый
container - контейнер, емкость
muscle - мускул, мышца
welcome - желанный, долгожданный, приятный
any - всякий, какой-нибудь, любой, никакой
traffic - движение, транспорт
believe - верить, полагать

Day #180
angry - рассерженный, сердитый,
tragedy - несчастье, трагедия
passage - проход, коридор, пассаж
telephone - телефон
file - папка, досье
right - правый, правильный
clever - умный
want - хотеть
use - использовать, пользоваться
quarter - четверть, четвертая часть

Day #181
piece - кусок, часть
pick - выбирать, срывать (плоды), ковырять
below - ниже, внизу, под
everywhere - везде, всюду
train - поезд
convinced - убежденный, уверенный
bank - банк, берег
upstairs - вверх, наверху, в верхнем этаже
past - прошлое, прошедшее
market - рынок

Day #182
valuable - ценный, полезный
will - завещание
touch - прикосновение, касание
trick - обман, хитрость
conclusion - умозаключение, вывод
object - возражать, протестовать
day - день
interruption - перерыв, пауза
afternoon - время после полудня
bet - держать пари

Day #183
show - показывать, демонстрировать
limit - ограничивать, ставить предел
rob - грабить, воровать
passenger - пассажир
fix - ремонтировать, устанавливать
even - ровный, равномерный
name - называть, назначать
team - команда
contact - связываться, общаться
go  away - уходить, уезжать

Day #184
score - счет
middle - середина
scare - пугать
national - национальный, народный
rid - освобождать, избавлять
set - ставить, класть, устанавливать
broad - широкий
play - пьеса, игра
strike - ударять (ся)
ask - спрашивать, просить

Day #185
opinion - мнение
age - возраст
call out - выкрикивать, вызывать
image - образ, имидж
gate - ворота
free - освобождать
pen - ручка
whom - кого, кому
cost - стоить
high - высокий

Day #186
agreement - согласие, соглашение
round - круглый
hit - ударять, попаать
price - цена
over - свыше, повсюду
shallow - мелкий, мелководный
may - мочь (разрешение)
turn up - усиливать, увеличивать, находить
pure - чистый, беспримесный
operation - операция, деятельность

Day #187
cap - кепка
bang - ударять, хлопать
connection - связь, соединение
terrible - страшный, ужасный
prove - доказывать, оказываться
pool - бассейн, лужа
off - с, со, от, выключенный
keep off - не подпускать, воздерживаться
impossible - невозможный, невыполнимый
gentle - ласковый, нежный

Day #188
circumstance - обстоятельство, случай
cause - причина, основание
involve - вовлекать, вмешивать
stay - оставаться, останавливаться
accident - несчастный случай, авария
achieve - добиваться, достигать
boat - лодка, судно
base - базировать, основывать
trust - верить, доверять (ся)
myself - себя, себе, сам

Day #189
so - итак, это, так
get off - сойти, слезть
rely - полагаться, зависеть
chance - возможность, случай
means - средство, способ, метод
hot - горячий, острый
tense - возбужденный, напряженный
tough - жесткий, трудный, выносливый
along - вдоль, по
wash - мыть (ся), стирать

Day #190
constantly - непрерывно, регулярно
prize - приз, премия
warning - предупреждение, предостережение
what - что
official - официальный
actual - фактический, реальный
power - сила
thumb - большой палец (руки)
big - большой
contrast - различие, контраст

Day #191
hers - ее
extraordinary - необычный, чрезвычайный
nice - хороший, приятный
remove - перемещать, снимать
main - главный, основной
protect - защищать, охранять
willing - готовый (сделать что-л.)
cut - резать
sure - уверенный
disturb - беспокоить, волновать

Day #192
roof - крыша
eye - глаз
embarrassed - смущенный, растерянный
man - человек, мужчина
space - пространство, космос
pollution - загрязнение
rank - звание, чин
upwards - снизу – вверх, наверх
professional - профессиональный
machine - машина, механизм

Day #193
worth - стоящий
search - искать, разыскивать
petrol - бензин
finish - заканчивать, завершать
name - имя
damage - вред, повреждение
break out - выламывать, вспыхивать
explanation - пояснение, разъяснение
snow - идти (о снеге)
sister - сестра

Day #194
cheat - обманывать, надувать
address - адресовать, направлять
his - его
television - телевизор
wing - крыло
month - месяц
expensive - дорогой
keen - острый, сильный, резкий
loose - свободный, неупакованный
pronunciation - произношение

Day #195
earth - Земля, земля
ear - ухо
careful - осторожный, внимательный
freeze - замораживать, замерзать
woman - женщина
worth - цена, стоимость
through - через, сквозь, насквозь
rest - отдыхать, опираться
pot - горшок, банка
appear - показываться, появляться

Day #196
get back - вернуть (ся)
please - радовать, угождать
distance - расстояние, дистанция
speed - скорость
spite - злость
whisper - шептать
tongue - язык
their - их
hold - дерать
scared - испуганный

Day #197
least - наименьший, наименее
give up - оставить, отказаться
feel - чувствовать, ощущать
us - нас
blind - слепой, ослепленный
allow - позволять, разрешать
attach - прикреплять, прилагать
this - данный
period - период
adjective - имя прилагательное

Day #198
flight - полет
weak - слабый
money - деньги
a - неопределенный артикль
success - успех, достижение
accept - принимать, соглашаться, признавать
swallow - глотать
lot - много
soon - скоро, вскоре
cruel - жестокий

Day #199
hurry - торопить (ся), подгонять
look around - осматривать
equal - равняться, соответствовать
keep - держать, хранить
balance - весы, равновесие, баланс
present - преподносить, дарить (with)
tie - связывать, привязывать
rule - правило
like - любить, нравиться
completely - вполне, полностью

Day #200
cover - накрывать, покрывать
scene - сцена, пейзаж
usually - обычно
either - любой (из двух), один из двух
around - всюду, кругом, повсюду, вокруг
tell - говорить, рассказывать
apart - в стороне, отдельно, отлично от
raise - поднимать, собирать
invitation - приглашение
hit - хит, попдание

Day #201
dinner - обед
run - бежать
business - дело, занятие
block - заграждать, блокировать
change - менять (ся), изменять (ся)
child - ребенок
escape - убегать, избегать
out - вне, снаружи, из, наружу, внешний
push - толкать (ся)
important - важный

Day #202
he - он
performance - выступление, выполнение
seriously - серьезно, обоснованно
best - лучший, наилучший
past - прошлый, прошедший
leg - нога (от бедра до ступни), ножка
radio - радио